1111111111111111111111111
1P000000000111100010000E1
100000C110000000100010001
1111111110011111111111111
1000C10000001C000110C0111
1C0001011000100C00C000011
100C00011000C00100000C011
1111111111111111111111111