1111111111111111111111111
1P000000000111100010000E1
1000000110000000100010001
1111111110011111111111111
10C00100000010000110C0111
100001011000100C00C000011
100C00C11000C00100000C011
1111111111111111111111111