1111111111
1P001C0E11
1000000011
1111111111