111111111111111111
1P01100000011C0001
100000011001111001
100110C110000000E1
111111111111111111
