1111111111111111111111111
1P011000000000000000000E1
1001100110011111111111111
1001100110011111111111111
1000000110000C000000C0011
1111111111111111111111111