111111111
1P001C0E1
100000001
111111111