1111111111
1P001C0011
1000000011
1111111111