111111111111111111
1P01100000000000E1
100110011001111111
100110011001111111
1000000110000C00C1
111111111111111111