11111111
10000E11
11P00101
10000C11
11111111
